#################
##====###########
##=##=###########
s==##=###########
#####=##========f
#####=##=########
#####====########
#################
#################