########
##====##
##=##=##
===##=##
#####=##
#####=##
#####=##
#####=##
#####=##